NO ./texture/text_EA.xpm
SO ./texture/text_WE.xpm
WE ./texture/text_NO.xpm
EA ./texture/text_SO.xpm


F 155,213,82
C 82,123,213



        1111111111111111111111111
        1000000000000000000000001
        1011000000000000000000001
        1001000000000000000000001
111111111011000001110000000000001
100W00000011000001110111111111111
10000000000000000000000000001
10000000000000001000000000001
10000000000000000000000000001
10000000000000000001000000001
10000000000000000000000000001
11100000000000000000000000001
11000000110101011100000000001
10000000000000001100000001001
1100000111010101111100000000111
11110111 1110101 100000000001
11111111 1111111 111111111111