NO ./texture/text_NO.xpm
SO ./texture/text_SO.xpm
WE ./texture/text_EA.xpm
EA ./texture/text_WE.xpm

F 61,15,78
C 10,95,52



11111111111111111111111111111
10000000000000000000000000001
100S0000100000000000000000001
10000000000000000001110000001
10000000000000000000010000001
10000000000000000000010000001
10000000000000000000000000001
11111111111111111111111111111
