NO ./texture/a_bluestone.xpm
SO ./texture/a_greystone.xpm
WE ./texture/a_purplestone.xpm
EA ./texture/a_redstone.xpm

F 61,15,78
C 10,95,52



111111111111111111111111111111
100000000001000000000100000001
100S00001000000000000110000001111
100000010000000000001110000001111
1000000100000000000000000001111
10000000000000000001110000001
10000010000010000000010000001
10000000000000000000010000001
1000000000000000000000000000111
100100000001000000000000000011
100001000000000000001000000001
1000010000010000000000000000111
11111111111111111111111111111
